X------------------ooooo-----------------Q-Q----
X-----------------o-----o---------------Q-------
X----------------o-------o-------------Q--------
X----------------o-------o-------------Q--------
X----------------o-------o-------------Q----%%%-
X----------------o-------o-------------Q-----||-
X-----------------o-----o--------------Q-----||-
XXXXXX-------------ooooo----------------QQQQQ||-