----------------
----------------
----------------
----------------
----------------
----------------
--------%%%%%%%%
---------||||||-
---------||||||-
---------||||||-
------%%%%%%%%%%
-------||||||||-
-------||||||||-
-------||||||||-
XXXXXXXXXXXXXXXX
XXXXXXXXXXXXXXXX
