----------------------------------------------------------------------------------------------------------------------------------------------------------------------------------------------------------
----------------------------------------------------------------------------------------------------------------------------------------------------------------------------------------------------------
----------------------------------------------------------------------------------------------------------------------------------------------------------------------------------------------------------
----------------------------------------------------------------------------------------------------------------------------------------------------------------------------------------------------------
-------------b--------------------------------------------------------------------------------------------------------------------------------------------------------------------------------------------
----------------------------------------------------------------------------------g-----------------------------------------------------------------------------------------------------------------------
----------------------!---------------------------------------------------------SSSSSSSS---SSS!--------------@-----------SSS----S!!S--------------------------------------------------------##------------
-------------------------------------------------------------------------------------------------------------------------------------------------------------------------------------------###------------
-------------------------------------------------------------------------------g----------------------------------------------------------------------------------------------------------####------------
----------------------------------------------------------------1------------------------------------------------------------------------------------------------------------------------#####------------
----------------!---S@S!S----------------------t---------tt------------------S@S--------------C-----SU----!--!--!-----S----------SS------#--#----------##--#------------SS!S------------######------------
--------------------------------B-------------tt---------t------------------------------------------------------------------------------##--##--------###--##--------------------------#######------------
----B--------------b------B-----b----b--------tt---------t-----------------------------------------------------------------------------###--###------####--###-----tt--------------tt-########------------
------------B-------------B-----b----B--------tt-----g---tt------------------------------------g-g--------k-----------------gg-g-g----####--####----#####--####----tt---------gg---tt#########--------#---
XXXXXXXXXXXXXXXXXXXXXXXXXXXXXXXXXXXXXXXXXXXXXXXXXXXXXXXXXXXXXXXXXXXXX--XXXXXXXXXXXXXXX---XXXXXXXXXXXXXXXXXXXXXXXXXXXXXXXXXXXXXXXXXXXXXXXXXXXXXXXXXXXXXXXX--XXXXXXXXXXXXXXXXXXXXXXXXXXXXXXXXXXXXXXXXXXXXXXX
XXXXXXXXXXXXXXXXXXXXXXXXXXXXXXXXXXXXXXXXXXXXXXXXXXXXXXXXXXXXXXXXXXXXX--XXXXXXXXXXXXXXX---XXXXXXXXXXXXXXXXXXXXXXXXXXXXXXXXXXXXXXXXXXXXXXXXXXXXXXXXXXXXXXXX--XXXXXXXXXXXXXXXXXXXXXXXXXXXXXXXXXXXXXXXXXXXXXXX